


                                                                C 000255,000000255     ,00255   

                                           NO ./textures/eagle.xpm




                     SO  ./textures/greystone.xpm



 EA ./textures/red.xpm

  WE ./textures/purplestone.xpm

 F 000000   ,  00  ,    0000000      
    1111111111111111111111111111111111111111111111111111111111111111111111111111111
   111111110000000000000000000000000000000000000000000000000000000000000001
   10000000000000000000000000000000000000000000000000000000000000000000001
   1000N00000000000000000000000000000000000000000000000000000000000000011111
1111111111110000000000000000000000000000000000000000000000000000000000000010
1000000000000000000000000000000000000000000000000000000000000000111111111111111
10000000000000000000000000000000000000000000000000000000000000001
10000000000000000000000000000000000000000000000000000000000000001
10000000000000000000000000000000000000000000000000000000000000001
10000000000000000000000000000000000000000000000000000000000000001
10000000000000000000000000000000000000000000000000000000000000001
10000000000000000000000000000000000000000000000000000000000000001
10000000000000000000000000000000000000000000000000000000000000001
10000000000000000000000000000000000000000000000000000000000000001
10000000000000000000000000000000000000000000000000000000000000001
10000000000000000000000000000000000000000000000000000000000000001
10000000000000000000000000000000000000000000000000000000000000001
10000000000000000000000000000000000000000000000000000000000000001
100000000000000000000000000000000000000000000000000000000000000011
111111111111111111111111111111111111111111111111111111111111111111
