
          C 255,255     ,255
      NO ./textures/eagle.xpm

    SO  ./textures/greystone.xpm
    EA ./textures/red.xpm

   WE ./textures/purplestone.xpm
     F  0,  0   ,    0



   11111
   1S001
   10001
   11111