C 254,20 ,30
R  2147483647 2147483647
NO      ./textures/eagle.xpm
SO ./textures/greystone.xpm
EA ./textures/red.xpm
WE ./textures/purplestone.xpm

S ./textures/tonneau.xpm
F  255, -000, 00

111111111111111111111111111111111
0000011                      110E1
111110111111111111111111111100001
111110111000200000000000010001111
100000000000000000111000100001
1100001000000000000000000001111
100001111111000000020000111111
111111100000000000 00000000001
111100000000001100000002000011
1                            1
110000000000011110000000000011
100000000000111000000000000011
11000000000011100000000000111100
110000000001111000000000000111
11101111111111111111111111111111111
  101
110001
11111