
          C 255,255     ,255
      NO ./textures/eagle.xpm

    SO  ./textures/greystone.xpm
    EA ./textures/red.xpm

   WE ./textures/purplestone.xpm
     F  0,  0   ,    0

111111111111111111111111111111111
0000011                      11001
111110111111111111111111111100001
111110111000000000000000010001111   
1000000000000000000111000100001
1100001000000000E00000000001111
1000011111110000000000001111111111111111111111111111111111
111111100000000000 0000000000000000000000000000000000000111
111100000000001100000000000011111111111111111111111111111111111111
1                            1
110000000000011110000000000011
100000000000111000000000000011
11000000000011100000000000111100
110000000001111000000000000111
11101111111111111111111111111111111
  101
110001
11111


