C 255,255,255
NO ./textures/eagle.xpm
SO ./textures/greystone.xpm
EA ./textures/red.xpm
WE ./textures/purplestone.xpm
F 255,255,255

11111111
10000001
1000N001
10000001
11111111




